%%%%%%%%%%%%%%%%%
%.   .         .%
%      .        %
%%%%%%%%% %%   .%
% P     %. %%   %
%.          %   %
%G       %.    .%
%%%%%%%%%%%%%%%%%
