%%%%%%%%%%%%%%%%%%%%
%P                 %
% %%%  %%%  %% %%% %
%                  %
%.         %       %
%          %       %
% %%%%%% . %%%G%%% %
%                  %
%           %      %
%.          %     .%
%%%%%%%%%%%%%%%%%%%%