%%%%%%%%%%%%%%%%%%%%
%.             %   %
%.%% %%.%% %% %% % %
%.       P       % %
% %%%%%%.  %%%%%%% %
%           G      %
%%%%%%%%%%%%%%%%%%%%