%%%%%%%
%P   .%
% %%% %
%  .  %
% %%% %
%.   G%
%%%%%%%